%%%%%%%%%%%%%%
%  .         %
%          . %
%  P    .    %
%            %
%   .     F. %
%  .         %
%        .   %
%  G.        %
%        .   %
%     .      %
%            %
% .    E   . %
%       .    %
%.           %
%%%%%%%%%%%%%%

