%%%%%%%%%%%%%%%%%%%%%%%%%%
%                        %
%                        %
%  P      .....    .     %
%                  .     %
%                  .     %
%                  .     %
%   .     .....    .     %
%   .                    %
%   .  E                 %
%   .                    %
%   .     .....    .     %
%                  .     %
%                  .     %
%                  .     %
%   .     .....    .     %
%   .                    %
%   .              F     %
%   .                    %
%   .     .....    .     %
%                  .     %
%                  .     %
%     G            .     %
%                  .     %
%%%%%%%%%%%%%%%%%%%%%%%%%%