%%%%%%%%%%%%%%%%%%%%%%%%%%
%         .            . %
%   .       .      .     %
%  P          .          %
%     .               .  %
%   .       .     .      %
%                        %
%     .            .     %
%                   .    %
%  .    E  .             %
%       .             .  %
%                  .     %
%      .        .        %
%  .         .         . %
%                .       %
%                        %
%   .  .     .        .  %
%                  F     %
%                        %
%  .       .  .   .      %
%                   .    %
%           .            %
%     .G           .     %
% .           .          %
%%%%%%%%%%%%%%%%%%%%%%%%%%
