%%%%%
%EF %
%.. %
% . %
%. .%
%   %
%  .%
%   %
%PG.%
%%%%%