%%%%%%%%%%%%%%%%%%%%%%%%%%%%%%%%%%
%   P                            %
%                            E   %
%                                %
%                                %
%                                %
%                                %
%                                %
%                                %
%                                %
%                          G     %
%                                %
%                                %
%                                %
%   F                            %
%                                %
%                                %
%%%%%%%%%%%%%%%%%%%%%%%%%%%%%%%%%%