%%%%%%%%%%%%%%%%%%%%%%%%%
%   P                 E %
%                       %
%   .                   %
%                       %
%       .               %
%                       %
%                  G    %
%            .          %
%                       %
% F                     %
%%%%%%%%%%%%%%%%%%%%%%%%%