%%%%%%%%%%%%%%%%%%%%%%%%%
%.. P  ....    E ....   %
%..  ...  ...  ...  ... %
%..  ...  ...  ...  ... %
%..    ....      .... G %
%..  ...  ...  ...  ... %
%..  ...  ...  ...  ... %
%..  F ....      ....   %
%%%%%%%%%%%%%%%%%%%%%%%%%