%%%%%%%%%%%%%%%%%%%%%%%%%
%   P.........          %
%            .          %
%            .          %
%            .        G %
%            .          %
%                       %
%                .      %
%%%%%%%%%%%%%%%%%%%%%%%%%