%%%%%%%%%%%%%%%%%%%%%%%%%
%   P        .       % E%
%       .            %%%%
%    ...                %
%                     G %
%                       %
%%%%                    %
%F %                    %
%%%%%%%%%%%%%%%%%%%%%%%%%