%%%%%%%%%%%%%%
%            %
%  P       F %
%    ...  .  %
%         .  %
% .  ...  .  %
% .  G       %
% .  ...  .  %
%         .  %
% .  ...  .  %
% .          %
% .  ...  .  %
%         .  %
%       E .  %
%            %
%%%%%%%%%%%%%%
