%%%%%%%%%%%%%%%%%%%%%%%%%%%%%%%%%%%%%%%%%%%%%%%%%%%
%                                                 %
%                                                 %
%  P                ..........            .       %
%                                         .       %
%                                         .       %
%                                         .       %
%                                         .       %
%                                         .       %
%                                         .       %
%                                         .       %
%                                         .       %
%      .             ..........           .       %
%      .                                          %
%      .      E                                   %
%      .                                          %
%      .                                          %
%      .                                          %
%      .                                          %
%      .                                          %
%      .                                          %
%      .             ..........           .       %
%                                         .       %
%                                         .       %
%                                         .       %
%                                         .       %
%                                         .       %
%                                         .       %
%                                         .       %
%                                         .       %
%      .             ..........           .       %
%      .                          F               %
%      .                                          %
%      .                                          %
%      .                                          %
%      .                                          %
%      .                                          %
%      .                                          %
%      .                                          %
%      .              ..........          .       %
%                                         .       %
%                                         .       %
%                                         .       %
%                                         .       %
%                  G                      .       %
%                                         .       %
%                                         .       %
%                                         .       %
%                                         .       %
%%%%%%%%%%%%%%%%%%%%%%%%%%%%%%%%%%%%%%%%%%%%%%%%%%%
