%%%%%%%%%%%%%%%%%%%%%%%%%%%%%%%%%%%%%%%%%%%%%%%%%%%
%                                                 %
%          .                .               .     %
%  P                                              %
%                   .                             %
%                                  .              %
%  .                    .                .        %
%           .                                     %
%                               .           .     %
%              .     .                            %
%     .                          .                %
%                       .               .     .   %
%          .      .             .                 %
%       .            .               .            %
%             E                              .    %
%          .          .             .             %
%  .                .           .             .   %
%            .           .                  .     %
%      .        .               .    .            %
%                                                .%
%             .               .                   %
%                                      .          %
%     .                                           %
%          .                    .             .   %
%                   .                             %
%                                     .           %
%           .                     .               %
%                          .         .   .        %
%       .         .                               %
%                           .              .      %
%       .                                .        %
%                 .               . F             %
%                     .               .           %
%                         .                       %
%            .                             .      %
%                             .                   %
%  .         .                                    %
%        .               . .           .          %
%                                          .      %
%               .            .                    %
%                         .                       %
%                  .               .         .    %
%  .     .                               .   .    %
%                 .                               %
%                  G       .        .         .   %
%      .      .                      .            %
%         .                .                      %
%                   .             .            .  %
%      .           .                          .   %
%%%%%%%%%%%%%%%%%%%%%%%%%%%%%%%%%%%%%%%%%%%%%%%%%%%

