%%%%%%%%%%%%%%%%%%%%%%%%%%%%%%%%%%%%%%%%%%%%%%%%%%%%%%%
%   .                       E    .            .       %
%                 .                    .          .   %
%      .                .                 .           %
%.            .             .                 .       %
%P .                 .              .                G%
%         .                    .                   .  %
%      .                   .              .           %
%   .           .                   .                 %
%                        .                    .    .  %
%      .          .         F        .                %
%%%%%%%%%%%%%%%%%%%%%%%%%%%%%%%%%%%%%%%%%%%%%%%%%%%%%%% 


