%%%%%%%%%%%%%%%%%%%%%%
%P         %        .%   
%                    %
%     %%%%%%%%%%%    %
%          E         %
%        .%%%.      G%
%          F         %
%     %%%%%%%%%%%    %
%                    %
%.         %        .%
%%%%%%%%%%%%%%%%%%%%%%
